//格式为源中文[Tab]新中文，可参考Dict下的字典
団長	团长	name, boy
スイカズラ	忍冬	name, girl
ジニア	百日菊	name, girl
ヒャクニチソウ	百日菊	name, girl
コルベット	加拿大耧斗菜	name, girl
ジュズダマ	薏苡	name, girl
タケ	竹	name, girl
ヤクノヒナホシ	药之雏星	name, girl
スノーベリー	白雪果	name, girl
カゲツ	翡翠木	name, girl
リサ	丽莎	name, girl
リースヴェルヌ	莉丝维尔努	name, girl
ウルザ・プラナアイス	乌鲁泽·普拉纳爱斯	name, girl
キチジョウソウ	吉祥草	name, girl
シギラリア	封印木	name, girl
ウィン	温	name, girl
ヤクーツク	雅库茨克	name, girl
コットン	棉花	name, girl
アリッサム	香雪球	name, girl
スズシロ	萝卜	name, girl
イオノプシジウム	紫罗兰	name, girl
ジャーマンアイリス	德国鸢尾	name, girl
サフラン	番红花	name, girl
オジギソウ	含羞草	name, girl
シーマニア	红岩桐	name, girl
デージー	雏菊	name, girl
サイネリア	瓜叶菊	name, girl
カレンデュラ	欧洲金盏花	name, girl
サンビタリア	蛇目菊	name, girl
ピンポンマム	杭白菊	name, girl
カカリア	绒缨菊	name, girl
ウィンターコスモス	鬼针草	name, girl
ノースポール	白晶菊	name, girl
ブラキカム	鹅河菊	name, girl
ディモルフォセカ	异果菊	name, girl
フキ	蜂斗菜	name, girl
アーティチョーク	菜蓟	name, girl
ヴァルンボン	瓦伦波恩	name, girl
ユリオプスデージー	黄金菊	name, girl
プリムラ	报春花	name, girl
シャコバサボテン	蟹爪兰	name, girl
サルビア	一串红	name, girl
チェリーセージ	小叶鼠尾草	name, girl
ローズマリー	迷迭香	name, girl
レオノチス	狮耳花	name, girl
ホワイトパンジー	白花三色堇	name, girl
イエローパンジー	黄花三色堇	name, girl
パープルパンジー	紫花三色堇	name, girl
イヌタデ	睫穗蓼	name, girl
ツバキ	山茶花	name, girl
ブラックバッカラ	黑色巴卡拉	name, girl
ロイヤルプリンセス	皇家公主蔷薇	name, girl
ノヴァーリス	诺瓦利斯	name, girl
モケ	木瓜	name, girl
ビワ	枇杷	name, girl
ノイバラ	野蔷薇	name, girl
ミニバラ	迷你玫瑰	name, girl
ジャコウバラ	麝香玫瑰	name, girl
スノードロップ	雪花莲	name, girl
エウカリス	亚马逊百合	name, girl
スイセン	水仙	name, girl
ケイトウ	青葙	name, girl
アエルバ	漠棉苋	name, girl
ミモザ	银荆	name, girl
アルストロメリア	六出花	name, girl
プルモナリア	肺草	name, girl
オンシジューム	文心兰	name, girl
シンビジューム	大花蕙兰	name, girl
デンドロビウム	石斛兰	name, girl
カトレア	卡特兰	name, girl
イオノシジウム	小文心兰	name, girl
パフィオペディルム	兜兰	name, girl
スイセイラン	齿舌兰	name, girl
アングレカム	彗星兰	name, girl
トリカブト	乌头	name, girl
ミスミソウ	三头草	name, girl
ニリンソウ	鹅掌草	name, girl
レシュノルティア	初恋草	name, girl
コーレア	遮瓣钟南香	name, girl
ユズ	香橙	name, girl
オリーブ	橄榄	name, girl
オウバイ	迎春花	name, girl
エノコログサ	狗尾草	name, girl
ジャノメエリカ	圣诞欧石楠	name, girl
チェッカーベリー	平铺白珠树	name, girl
ヘザー	帚石楠	name, girl
エリカ・クリスマスパレード	冬石楠	name, girl
レウコフィルム	红花玉芙蓉	name, girl
エレモフィラ	喜沙木	name, girl
オキザリス	双色酢浆草	name, girl
マネッチア	蔓炎花	name, girl
ブバルディア	寒丁子	name, girl
ヒナソウ	美耳草	name, girl
ルクリア	滇丁香	name, girl
ヤツデ	八角金盘	name, girl
シンクライリアナ	珊瑚塔	name, girl
ハートツリー	北仲	name, girl
ブルーエルフィン	紫蝶花	name, girl
クラリンドウ	垂茉莉	name, girl
ポインセチア	圣诞红	name, girl
ハツユキソウ	银边翠	name, girl
ユキハナソウ	雪华草	name, girl
ホーリー	欧洲冬青	name, girl
ソヨゴ	具柄冬青	name, girl
アロエ	芦荟	name, girl
ロウバイ	腊梅	name, girl
ストレリチア	鹤望兰	name, girl
ベルゲニア	岩白菜	name, girl
ツキトジ	月兔耳	name, girl
カランコエ	伽蓝菜	name, girl
ハカラメ	落地生根	name, girl
クリスマスベゴニア	冬海棠	name, girl
リトープス	生石花	name, girl
セルリア	新娘花	name, girl
チューベローズ	晚香玉	name, girl
ウェルウィッチア	百岁兰	name, girl
ノラナ	假茄	name, girl
ホウセンカ	凤仙花	name, girl
ナツメ	枣	name, girl
インパチェンス	非洲凤仙花	name, girl
サテラ	萨特拉	name, girl
リンネソウ	北极花	name, girl
エスカロニア	南鼠刺	name, girl
クリスマスブッシュ	朱萼梅	name, girl
ソテツ	苏铁	name, girl
トリトマ	火把莲	name, girl
デイゴ	刺桐	name, girl
クロサンドラ	十字爵床	name, girl
タッカ・シャントリエリ	箭根薯	name, girl
メイ	梅	name, girl
ハル	春	name, girl
一ノ瀬鈴夏	一之濑铃夏	name, girl
イリス	伊莉丝	name, girl
さんご	珊瑚	name, girl
ヒヨコマメ	鹰嘴豆	name, girl
サン	太阳	name, girl
ビカクシダ	鹿角蕨	name, girl
スターグラス	星草	name, girl
エンドウ	豌豆	name, girl
テトラスティグマ	崖爬藤	name, girl
レモン	柠檬	name, girl
ハイビスカス	朱瑾	name, girl
ビロードアオイ	药蜀葵	name, girl
クレナイ	红紫阳	name, girl
アジサイ	绣球花	name, girl
グラジオラス	唐菖蒲	name, girl
モントブレチア	射干菖蒲	name, girl
キキョウ	桔梗	name, girl
ヒマワリ	向日葵	name, girl
ガイラルディア	天人菊	name, girl
ヘレニウム	堆心菊	name, girl
ガザニア	勋章菊	name, girl
フジバカマ	泽兰	name, girl
ルドベキア	金光菊	name, girl
ヘリクリサム	蜡菊	name, girl
チトニア	肿柄菊	name, girl
ウサギギク	兔菊	name, girl
ソリダスター	一枝苑	name, girl
シルフィウム	指南菊	name, girl
チコリー	菊苣	name, girl
ヘリアンサス	葵花	name, girl
バードック	牛蒡	name, girl
ヘリオプシス	赛菊芋	name, girl
メランポジューム	黑足菊	name, girl
チコレ	栽培菊苣	name, girl
アンモビウム	银包菊	name, girl
チシャ	莴苣	name, girl
バニーカクタス	白桃扇	name, girl
エイル	艾尔	name, girl
レッドジンジャー	红姜花	name, girl
クルクマ	姜荷花	name, girl
ゲットウ	艳山姜	name, girl
スイレン	睡莲	name, girl
アカバナスイレン	红花睡莲	name, girl
オオオニバス	王莲	name, girl
イブキトラノオ	椭圆叶蓼	name, girl
イタドリ	虎杖	name, girl
スイバ	酸模	name, girl
ヒメシャラ	日本紫茎	name, girl
サカキ	红淡比	name, girl
グリーンベル	白玉草	name, girl
レインボーローズ	彩虹玫瑰	name, girl
ブラックベリー	黑莓	name, girl
モスローズ	苔玫瑰	name, girl
カライトソウ	日本地榆	name, girl
ゼフィランサス	韭莲	name, girl
レインリリー	葱兰	name, girl
ハブランサス	大韭兰	name, girl
アガパンサス	百子莲	name, girl
ヒルガオ	昼颜牵牛花	name, girl
ヨルガオ	月光花	name, girl
アサガオ	牵牛花	name, girl
ルコウソウ	茑萝	name, girl
カイコウズ	鸡冠刺桐	name, girl
カズラ	葛	name, girl
ヒスイカズラ	翡翠葛	name, girl
サイトウ	菜豆	name, girl
カサブランカ	香水百合	name, girl
ヤマユリ	天香百合	name, girl
オトメユリ	乙女百合	name, girl
ヒメユリ	姬百合	name, girl
サンダーソニア	宫灯百合	name, girl
ユリ	百合	name, girl
カノコユリ	鹿子百合	name, girl
クルマユリ	浙江百合	name, girl
グロリオサ	嘉兰	name, girl
ベッセラ	珊瑚坠	name, girl
ヘメロカリス	萱草	name, girl
ウバユリ	姥百合	name, girl
ミルトニア	堇花兰	name, girl
コランバイン	耧斗菜	name, girl
ヘンルーダ	芸香	name, girl
タチバナ	桔	name, girl
ファンフラワー	紫扇花	name, girl
アンスリウム	火鹤花	name, girl
ローマンカモミール	果香菊	name, girl
ライムギ	黑麦	name, girl
レモングラス	柠檬草	name, girl
ヒペリカム	金丝桃	name, girl
オシロイバナ	紫茉莉	name, girl
カラスウリ	王瓜	name, girl
ペポ	夏南瓜	name, girl
オオバコ	车前草	name, girl
ツキミソウ	月见草	name, girl
ゴデチア	古代稀	name, girl
アンゲロニア	天使花	name, girl
リシアンサス	观赏葱	name, girl
エキザカム	藻百年	name, girl
カタバミ	酢浆草	name, girl
サオトメバナ	鸡屎藤	name, girl
クチナシ	栀子花	name, girl
キヌタソウ	砧草	name, girl
サンタンカ	仙丹花	name, girl
コフェア	咖啡	name, girl
アカンサス	叶蓟	name, girl
ベロペロネ	小虾花	name, girl
アフェランドラ	单药花	name, girl
ディプラデニア	飘香藤	name, girl
プルメリア	缅栀花	name, girl
ニチニチソウ	长春花	name, girl
ランタナ	马缨丹	name, girl
フォックスフェイス	乳茄	name, girl
ベラドンナ	颠茄	name, girl
ワルナスビ	北美刺龙葵	name, girl
ハバネロ	哈瓦那辣椒	name, girl
ヤコウボク	夜香木	name, girl
ホップ	蛇麻	name, girl
キャッツテール	铁苋菜	name, girl
クロトン	变叶木	name, girl
ハナキリン	虎刺梅	name, girl
マンリョウ	朱砂根	name, girl
センリョウ	草珊瑚	name, girl
カカオ	可可树	name, girl
ギンバイソウ	银梅草	name, girl
ロエオ	紫背万年青	name, girl
エケベリア	拟石莲花	name, girl
ロケア	绯红青锁龙	name, girl
ムーングロウ	月光花	name, girl
ポーチュラカ	马齿苋	name, girl
ザクロ	石榴	name, girl
キウイ	奇异果	name, girl
ライオンゴロシ	魔鬼爪	name, girl
セリ	水芹	name, girl
キャロット	胡萝卜	name, girl
サラセニア	瓶子草	name, girl
プラタナス	悬铃木	name, girl
シバザクラ	芝樱	name, girl
セアノサス	美洲茶	name, girl
グーズベリー	醋栗	name, girl
ギリア	吉利花	name, girl
スキラ	绵枣儿	name, girl
ネコヤナギ	细柱柳	name, girl
スグリ	茶藨子	name, girl
バーゼリア	饰球花	name, girl
イセビ	日本荚蒾	name, girl
グミ	胡颓子	name, girl
ミツマタ	结香	name, girl
シィル・プライン	希露·普莱恩	name, girl
ジンチョウゲ	瑞香	name, girl
アマドコロ	玉竹	name, girl
スィーリア	苏利亚	name, girl
美桜	美樱	name, girl
カシス	黑加仑	name, girl
ハシバミ	榛	name, girl
葛城真理奈	葛城真理奈	name, girl
アオキ	青木	name, girl
マリア・カスタード	玛丽亚·卡斯塔多	name, girl
カンガルーポー	袋鼠爪	name, girl
ブロス	布罗斯	name, girl
九鬼旭	九鬼旭	name, girl
風嶺雪月花	风岭雪月花	name, girl
カベルネ・ソーヴィニヨン	赤霞珠	name, girl
ソーヴィニヨン・ブラン	长相思	name, girl
ブナ	山毛榉	name, girl
キングスクロス	国王十字	name, girl
ヴィクトリア	维多利亚	name, girl
ウメ	梅	name, girl
さくらんぼ	樱桃	name, girl
アニソドンテア	小木槿	name, girl
アブラナ	油菜花	name, girl
イベリス	屈曲花	name, girl
ムラサキハナナ	诸葛菜	name, girl
マルコミア	希腊芥	name, girl
フリージア	小苍兰	name, girl
イキシア	小鸢尾	name, girl
セントポーリア	非洲堇	name, girl
ヒポシルタ	袋鼠花	name, girl
マーガレット	玛格丽特	name, girl
ダリア	大丽菊	name, girl
ローダンセ	鳞托菊	name, girl
キンセンカ	金盏花	name, girl
ハルジオン	春紫菀	name, girl
アザミ	蓟	name, girl
フェリシア	费利西亚	name, girl
クレピス	桃色蒲公英	name, girl
スピランサス	桂圆菊	name, girl
キクナ	春菊	name, girl
サンチョーク	洋姜	name, girl
カウスリップ	黄花九轮草	name, girl
アナガリス	琉璃繁缕	name, girl
サボテン	仙人掌	name, girl
ホシクジャク	假昙花	name, girl
スズラン	铃兰	name, girl
スミレ	紫花地丁	name, girl
ビオラ	堇菜	name, girl
キランソウ	筋骨草	name, girl
コマチソウ	高雪轮	name, girl
シャボンソウ	肥皂草	name, girl
ハコベラ	繁缕	name, girl
イチゴ	草莓	name, girl
バラ	蔷薇	name, girl
サクラ	樱	name, girl
ユキヤナギ	珍珠绣秋菊	name, girl
モモ	桃	name, girl
ハナモモ	桃花	name, girl
サクランボ	樱桃	name, girl
アプリコット	杏	name, girl
カンヒザクラ	绯寒樱	name, girl
プラム	李	name, girl
キジムシロ	委陵菜	name, girl
プルーン	西梅	name, girl
ジューンベリー	加拿大唐棣	name, girl
ゴールドバニー	金秀娃	name, girl
アーモンド	扁桃	name, girl
アマリリス	孤挺花	name, girl
キルタンサス	垂筒花	name, girl
イフェイオン	花韭	name, girl
ヒノキ	桧	name, girl
レンゲソウ	紫云英	name, girl
アカシア	金合欢	name, girl
ハリエンジュ	刺槐	name, girl
ルピナス	羽扇豆	name, girl
キヌサヤ	豌豆	name, girl
ハーデンベルギア	紫哈登柏豆	name, girl
エニシダ	金雀儿	name, girl
ハクモクレン	白木莲	name, girl
ナイトメア	恶梦（猪牙花）	name, girl
ナルコユリ	镰叶黄精	name, girl
コチョウラン	蝴蝶兰	name, girl
マスデバリア	三尖兰	name, girl
エビネ	虾脊兰	name, girl
バニラ	香草	name, girl
アネモネ	银莲花	name, girl
クリスマスローズ	圣诞玫瑰	name, girl
フクジュソウ	侧金盏花	name, girl
ラナンキュラス	洋牡丹	name, girl
ヒメリュウキンカ	榕叶毛茛	name, girl
アンリ	亨利	name, girl
オキナグサ	朝鲜白头翁	name, girl
サザンクロス	南十字花	name, girl
オレンジ	柳橙	name, girl
ボロニア	石南香	name, girl
ユキモチソウ	灯台莲	name, girl
ウサギノオ	兔尾草	name, girl
ペラルゴニウム	天竺葵	name, girl
ブーゲンビリア	叶子花	name, girl
キンギョソウ	金鱼草	name, girl
オオイヌノフグリ	阿拉伯婆婆纳	name, girl
ツツジ	杜鹃花	name, girl
クランベリー	蔓越莓	name, girl
アケビ	木通	name, girl
アセビ	马醉木	name, girl
カルセオラリア	蒲包花	name, girl
ペリストロフェ	观音草	name, girl
ビンカ	蔓长春花	name, girl
ワスレナグサ	勿忘草	name, girl
ボリジ	琉璃苣	name, girl
アンチューサ	牛舌草	name, girl
メイゲツカエデ	羽扇槭	name, girl
バーベナ	马鞭草	name, girl
カリブラコア	舞春花	name, girl
ユーカリ	尤加利树	name, girl
コータロ	幸太郎	name, boy
ソータ	宗太	name, boy
ヤドリギ	槲寄生	name, girl
タツタソウ	鲜黄连	name, girl
リュウゼツラン	龙舌兰	name, girl
ユキザサ	鹿药	name, girl
ムスカリ	葡萄风信子	name, girl
ボタン	叶牡丹	name, girl
ポピー	虞美人	name, girl
メコノプシス	绿绒蒿	name, girl
オニゲシ	鬼罂粟	name, girl
ステファノティス	耳药藤	name, girl
メギ	日本小檗	name, girl
ゼブリナ	吊竹梅	name, girl
ブライダルベール	细梗鸭跖草	name, girl
マロニエ	欧洲七叶树	name, girl
ランプランサス	松叶菊	name, girl
ピンクッション	风轮花	name, girl
マカダミア	夏威夷果	name, girl
ヨウラクボタン	荷包牡丹	name, girl
ガジュマル	细叶榕	name, girl
カカラ	菝葜	name, girl
アベリア	大花六道木	name, girl
ツルバキア	紫瓣花	name, girl
ゼンマイ	紫薇	name, girl
ガーリックバイン	蒜香藤	name, girl
ミムルス	沟酸浆	name, girl
コナラ	枹栎	name, girl
シイタケ	香菇	name, girl
見当かなみ	见当加奈美	name, girl
茜	茜	name, girl
オモイグサ	野菰	name, girl
上杉謙信	上杉谦信	name, girl
オイランソウ	天蓝绣球	name, girl
ルリマツリ	蓝花丹	name, girl
シラカバ	白桦	name, girl
イヌマキ	罗汉松	name, girl
十部梨々夢	十部梨梨梦	name, girl
朱雀院紅葉	朱雀院红叶	name, girl
マルバノキ	双花木	name, girl
ベル	达尔马提亚风铃草	name, girl
ヨシノ	吉野	name, girl
ミヤコ	都	name, girl
シダレヤナギ	垂柳	name, girl
ノウゼンカズラ	凌霄	name, girl
ウキツリボク	蔓性风铃花	name, girl
ハナオクラ	黄蜀葵	name, girl
パボニア	帕莲花	name, girl
ガンライコウ	苋	name, girl
ハナショウブ	花菖蒲	name, girl
ストレプトカーパス	堇兰	name, girl
ローレンティア	同瓣草	name, girl
コスモス	大波斯菊	name, girl
マリーゴールド	万寿菊	name, girl
ガーベラ	非洲菊	name, girl
チョコレートコスモス	巧克力波斯菊	name, girl
エキナセア	紫锥花	name, girl
ヨモギ	五月艾	name, girl
シオン	紫苑	name, girl
イモーテル	永久花	name, girl
アルテミシア	苦艾	name, girl
クラスペディア	金仗花	name, girl
ゴギョウ	鼠麹草	name, girl
ピレスラム	除虫菊	name, girl
ルリギク	琉璃菊	name, girl
クジャクソウ	孔雀草	name, girl
ミヤマヨメナ	六月菊花	name, girl
リュウノウギク	龙脑菊	name, girl
シクラメン	仙客来	name, girl
ゲッカビジン	昙花	name, girl
サンカクサボテン	量天尺	name, girl
ミント	薄荷	name, girl
ラベンダー	薰衣草	name, girl
ワタチョロギ	绵毛水苏	name, girl
コリウス	鞘蕊花	name, girl
ネペタ	荆芥	name, girl
ホルムショルディア	冬红	name, girl
ウエストリンギア	迷南苏	name, girl
ブルーロータス	蓝莲花	name, girl
サザンカ	茶梅	name, girl
アイ	蓼蓝	name, girl
シノネ	羊蹄	name, girl
クリンユキフデ	支柱蓼	name, girl
ワレモコウ	地榆	name, girl
チャノキ	茶树	name, girl
ワビスケ	侘助茶花	name, girl
オトメツバキ	乙女椿	name, girl
ナデシコ	石竹花	name, girl
リクニス	剪秋罗	name, girl
センニチコウ	千日红	name, girl
カリン	花梨	name, girl
シモツケ	粉花绣线菊	name, girl
ネリネ	纳丽石蒜	name, girl
ヒガンバナ	彼岸花	name, girl
スギ	杉	name, girl
シロツメクサ	白三叶草	name, girl
コキア	地肤	name, girl
キンモクセイ	丹桂	name, girl
ストロベリーキャンドル	红花诘草	name, girl
ハギ	胡枝子	name, girl
クローバー	三叶草	name, girl
アズキ	红豆	name, girl
ジャスミン	茉莉	name, girl
ホトトギス	油点草	name, girl
リリオペ	阔叶麦门冬	name, girl
オニユリ	卷丹	name, girl
バンダ	万代兰	name, girl
クレマチス	铁线莲	name, girl
シュウメイギク	打破碗花花	name, girl
スキミア	茵芋	name, girl
カラタチ	枳	name, girl
アッシュ	白蜡树	name, girl
ススキ	中国芒	name, girl
アシ	芦苇	name, girl
パンパスグラス	蒲苇	name, girl
カンナ	美人蕉	name, girl
オトギリソウ	小连翘	name, girl
ヒョウタン	葫芦	name, girl
ヘチマ	丝瓜	name, girl
ブリオニア	泻根	name, girl
フクシア	吊钟花	name, girl
ベロニカ	婆婆纳	name, girl
ラッセリア	爆仗竹	name, girl
ステラ	雪花蔓	name, girl
ディアスキア	双矩花	name, girl
ケロネ	鳌头花	name, girl
ネメシア	龙面花	name, girl
リンドウ	龙胆	name, girl
センブリ	日本獐牙菜	name, girl
アカネ	茜草	name, girl
アイビー	常春藤	name, girl
カヤナ	爵床	name, girl
ブルースター	天蓝尖瓣藤	name, girl
ヘリオトロープ	天芥菜	name, girl
ヒギリ	赪桐	name, girl
ランギク	灰叶莸	name, girl
トウガラシ	辣椒	name, girl
キンレンカ	早金莲	name, girl
ギョリュウバイ	麦卢卡	name, girl
ヒマ	蓖麻	name, girl
リュウノヒゲ	麦冬	name, girl
バルーンバイン	倒地铃	name, girl
バウエラ	车叶梅	name, girl
スイギョク	布袋莲	name, girl
アエオニウム	莲花掌	name, girl
ミセバヤ	圆扇八宝	name, girl
ハゼラン	土人参	name, girl
レウイシア	露薇花	name, girl
マツバボタン	松叶牡丹	name, girl
クフェア	萼距花	name, girl
オミナエシ	败酱	name, girl
エルダーフラワー	接骨木	name, girl
パイナップル	凤梨	name, girl
コルチカム	秋水仙	name, girl
クルミ	胡桃	name, girl
トケイソウ	西番莲	name, girl
モンヨウショウ	豹纹竹芋	name, girl
エノキ	朴树	name, girl
魔想志津香	魔想志津香	name, girl
ゲッケイジュ	月桂	name, girl
ヒサカキ	铃木	name, girl
天久保百合	天久保百合	name, girl
カノコソウ	缬草	name, girl
マティア	玛蒂娅	name, girl
シナモン	肉桂	name, girl
アオ	青	name, girl
シロ	白	name, girl
ゴジアオイ	岩玫瑰	name, girl
ラフレシア	大王花	name, girl
りんご	苹果	name, girl
モルチアナ	锦葵	name, girl
タチアオイ	蜀葵	name, girl
パキラ	马拉巴栗	name, girl
ルナリア	银扇草	name, girl
アナベル	乔木绣球	name, girl
ルルーナ	露露娜	name, girl
ハボタン	叶牡丹	name, girl
スズナ	芜菁	name, girl
エーデルワイス	雪绒花	name, girl
オトメギキョウ	乙女桔梗	name, girl
ブルーベル	蓝铃花	name, girl
ホタルブクロ	紫斑风铃草	name, girl
ヤツシロソウ	聚花风铃草	name, girl
タンポポ	蒲公英	name, girl
ヤグルマギク	矢车菊	name, girl
アスター	翠菊	name, girl
アキレア	蓍	name, girl
シロタエギク	银叶菊	name, girl
オナモミ	苍耳	name, girl
タラゴン	龙蒿	name, girl
ルリタマアザミ	硬叶蓝刺头	name, girl
オステオスペルマム	蓝眼菊	name, girl
サントリナ	绵杉菊	name, girl
リアトリス	蛇鞭菊	name, girl
サクラソウ	樱草	name, girl
フィソステギア	随意草	name, girl
カーネーション	康乃馨	name, girl
スイートウィリアム	须苞石竹	name, girl
アグロステンマ	麦仙翁	name, girl
フランネルソウ	毛剪秋罗	name, girl
ビスカリア	鞠翠花	name, girl
セラスチウム	夏雪草	name, girl
カスミソウ	缕丝花	name, girl
ナナカマド	合花楸	name, girl
リンゴ	苹果	name, girl
ピラカンサ	火棘	name, girl
コデマリ	麻叶绣线菊	name, girl
マルメロ	榅桲	name, girl
ゲウム	路边青	name, girl
スノーフレーク	雪片莲	name, girl
ヒメノカリス	水鬼蕉	name, girl
イトスギ	柏木	name, girl
スイートピー	香豌豆	name, girl
ミヤコグサ	百脉根	name, girl
ライラック	欧丁香	name, girl
ヘリコニア	鹤蕉	name, girl
クロユリ	黑百合	name, girl
レッドチューリップ	红花郁金香	name, girl
イエローチューリップ	黄花郁金香	name, girl
パープルチューリップ	紫花郁金香	name, girl
ホワイトチューリップ	白花郁金香	name, girl
リューココリーネ	阳光百合	name, girl
アリウム	观赏葱	name, girl
テッポウユリ	铁炮百合	name, girl
フリチラリア	花贝母	name, girl
リーガルリリー	岷江百合	name, girl
タカサゴユリ	台湾百合	name, girl
ギンラン	银兰	name, girl
エピデンドラム	美洲石斛	name, girl
リカステ	捧心兰	name, girl
ネジバナ	绶草	name, girl
デルフィニウム	翠雀	name, girl
ニゲラ	黑种草	name, girl
ラークスパー	千鸟草	name, girl
キンポウゲ	金凤花	name, girl
ボタンヅル	女萎	name, girl
ミカン	橘子	name, girl
ブンタン	柚子	name, girl
ハナミズキ	大花四照花	name, girl
ミズキ	灯台树	name, girl
カラー	海芋	name, girl
テンナンショウ	天南星	name, girl
ポトス	绿萝	name, girl
シンゴニウム	合果芋	name, girl
コムギ	小麦	name, girl
ゼラニウム	天竺葵	name, girl
ギンリョウソウ	球果假水晶兰	name, girl
スズランノキ	酸模树	name, girl
サツキ	皋月杜鹃	name, girl
カルミア	山月桂	name, girl
コケモモ	越橘	name, girl
ブルーベリー	蓝莓	name, girl
エノテラ	月见草	name, girl
ナイトフロックス	夜色福禄考	name, girl
ペンステモン	钓钟柳	name, girl
トレニア	蝴蝶草	name, girl
バーバスカム	毛蕊花	name, girl
ヘーベ	长阶花	name, girl
ペンタス	繁星花	name, girl
バンテイシ	六月雪	name, girl
サンゴバナ	珊瑚花	name, girl
ニシキギ	卫矛	name, girl
モミジ	红叶	name, girl
イチョウ	银杏	name, girl
デュランタ	金露花	name, girl
クマツヅラ	熊葛	name, girl
ホオズキ	酸浆	name, girl
ポテト	马铃薯	name, girl
ブロワリア	蓝英花	name, girl
ニコチアナ	花烟草	name, girl
ティーツリー	互叶白千层	name, girl
モミノキ	冷杉	name, girl
マツ	松树	name, girl
プロテア	海神花	name, girl
ヒトリシズカ	银线草	name, girl
ナンテン	南天竹	name, girl
イカリソウ	淫羊藿	name, girl
ブローディア	紫灯花	name, girl
シャクヤク	芍药	name, girl
シャムサクララン	心叶球兰	name, girl
ハートカズラ	爱之蔓	name, girl
ユキノシタ	虎耳草	name, girl
クモマグサ	云间草	name, girl
ヒューケラ	矾根	name, girl
ネモフィラ	粉蝶花	name, girl
ツユクサ	鸭跖草	name, girl
キリンソウ	费菜	name, girl
ハゼ	野漆	name, girl
スモークツリー	欧黄栌	name, girl
アナナス	观赏凤梨	name, girl
ペペロミア	草胡椒	name, girl
ユズリハ	交让木	name, girl
パクチー	香菜	name, girl
ディル	莳萝	name, girl
ブルーレースフラワー	翠珠花	name, girl
チャービル	有喙欧芹	name, girl
コマクサ	驹草	name, girl
リムナンテス	池花	name, girl
サンデリアーナ	富贵竹	name, girl
アサザ	莕菜	name, girl
ミツガシワ	睡菜	name, girl
クワイ	慈姑	name, girl
タイリンオモダカ	蒙特登慈姑	name, girl
ウサギゴケ	兔兔苔	name, girl
ビバーナム	荚蒾	name, girl
バイカソウ	梅花草	name, girl
スターチス	星辰花	name, girl
ニレ	榆	name, girl
エリンギ	杏鲍菇	name, girl
マイヅルソウ	舞鹤草	name, girl
パピルス	纸莎草	name, girl
ヤブデマリ	粉团	name, girl
クレオメ	醉蝶花	name, girl
プミラ	薜荔	name, girl
ツリフネソウ	野凤仙花	name, girl
ミズヒナゲシ	水金英	name, girl
ドラセナ	龙血树	name, girl
マジナータ	千年木	name, girl
アルメリア	海石竹	name, girl
アザリン	阿萨琳	name, girl
モウセンゴケ	圆叶茅膏菜	name, girl
ハナイ	花蔺	name, girl
ムクゲ	木槿	name, girl
ラバテラ	花葵	name, girl
クレソン	西洋菜	name, girl
ストック	紫罗兰	name, girl
カルダミネ・リラタ	水田碎米荠	name, girl
アイリス	鸢尾花	name, girl
カキツバタ	燕子花	name, girl
ニワゼキショウ	庭菖蒲	name, girl
スパラキシス	水仙菖蒲	name, girl
アヤメ	溪荪	name, girl
トリトニア	观音兰	name, girl
イチハツ	鸢尾草	name, girl
シャガ	钻石花	name, girl
スミシアンサ	垂筒苣苔	name, girl
アキメネス	长筒花	name, girl
ロベリア	六倍利	name, girl
サワギキョウ	山梗菜	name, girl
ヨメナ	嫁菜	name, girl
コオニタビラコ	稻槎菜	name, girl
イソギク	矶菊	name, girl
アステリカリス	滨海叶苞菊	name, girl
ツワブキ	大吴风草	name, girl
ハマシオン	海紫菀	name, girl
ソリダゴ	一枝黄花	name, girl
ハマギク	日本滨菊	name, girl
リシマキア	珍珠菜	name, girl
クリンソウ	日本樱草	name, girl
ラミウム	野芝麻	name, girl
バジル	罗勒	name, girl
タツナミソウ	黄芩	name, girl
オレガノ	牛至	name, girl
ヒメオドリコソウ	圆齿野芝麻	name, girl
トゥルシー	圣罗勒	name, girl
オドリコソウ	短柄野芝麻	name, girl
ヒツジグサ	子午莲	name, girl
ミズヒキ	金线草	name, girl
ミゾソバ	戟叶蓼	name, girl
ハマナデシコ	日本石竹	name, girl
ヤマブキ	棣棠花	name, girl
ハマナス	滨茄子	name, girl
クロバナロウゲ	沼委陵菜	name, girl
キクモモ	菊桃	name, girl
クリナム	文殊兰	name, girl
コンボルブルス	三色旋花	name, girl
ネムノキ	合欢树	name, girl
バイケイソウ	梅蕙草	name, girl
スカシユリ	透百合	name, girl
トキソウ	朱兰	name, girl
バイカモ	梅花藻	name, girl
キツネノボタン	钩柱毛茛	name, girl
リュウキンカ	驴蹄草	name, girl
スパティフィラム	白鹤芋	name, girl
トウカ	稻禾	name, girl
ホルデュウム	大麦	name, girl
ムギ	麦子	name, girl
フウロソウ	老鹳草	name, girl
ヤマゴーヤ	毒瓜	name, girl
ジギタリス	毛地黄	name, girl
オオカワヂシャ	北水苦荬	name, girl
ガウラ	山桃草	name, girl
ミズタマソウ	南方露珠草	name, girl
ミズバコパ	水过长沙	name, girl
リンデルニア	水精灵	name, girl
クガイソウ	九阶草	name, girl
リナリア	柳穿鱼	name, girl
パキスタキス	金苞花	name, girl
アデニウム	沙漠玫瑰	name, girl
キョウチクトウ	夹竹桃	name, girl
メルテンシア	滨紫草	name, girl
リッピア	姬岩垂草	name, girl
クコ	枸杞	name, girl
フユサンゴ	玉珊瑚	name, girl
シザンサス	蛾蝶花	name, girl
ハシリドコロ	毒芹	name, girl
ダチュラ	曼陀罗	name, girl
クローブ	丁香	name, girl
マンチニール	毒疮树	name, girl
ヒヤシンス	风信子	name, girl
ホスタ	玉簪花	name, girl
チオノドクサ	雪光花	name, girl
オーニソガラム	伞花虎眼万年青	name, girl
カガミ	萝藦	name, girl
ダイモンジソウ	齿瓣虎耳草	name, girl
ミズアオイ	雨久花	name, girl
ポンテデリア	梭鱼草	name, girl
コナギ	鸭舌草	name, girl
インクバナ	紫露草	name, girl
セダム	景天	name, girl
イワレンゲ	钝叶瓦松	name, girl
ヘナ	散沫花	name, girl
ミソハギ	千屈菜	name, girl
ウルシ	漆树	name, girl
フェンネル	茴香	name, girl
アンゼリカ	欧白芷	name, girl
エリンジウム	刺芹	name, girl
ブプレウルム	柴胡	name, girl
ヘムロック	毒参	name, girl
ハス	莲花	name, girl
ケペラ	凯佩拉	name, girl
シルキト	西尔基特	name, girl
リコ	莉可	name, girl
ナイドホグル	尼德霍格尔	name, girl
リリ	莉莉	name, girl
ベリアル	彼列	name, girl
ゴールドメダル	芳香万寿菊	name, girl
ケヤキ	榉	name, girl
ベルゼブブ	别西卜	name, girl
ムラサキシキブ	日本紫珠	name, girl
ルシフェル	路西法	name, girl
リン	凛	name, girl
ゴッホ	梵荷	name, girl
レン	莲	name, girl
ヒャクリョウ	百两金	name, girl
ジュウリョウ	紫金牛	name, girl
ヘビイチゴ	皱果蛇莓	name, girl
ウツギ	齿叶溲疏
上和泉桜夜	上河泉樱夜	name, girl
朱雀院椿	朱雀院椿	name, girl
藍原しおん	蓝原诗音	name, girl
フリージア・ゴッドスピード	弗莉吉娅・神速	name, girl
サンカヨウ	山荷叶	name, girl
秋山凜子	秋山凛子	name, girl
イヌショウマ	犬升麻	name, girl
水城ゆきかぜ	水城雪风	name, girl
フラスベルグ	芙拉丝贝尔格	name, girl
井河アサギ		井河阿莎姬	name, girl
アルカ	古果	name, girl
ブルードラゴン	藿香叶绿绒蒿	name, girl
鬼崎きらら	鬼崎绮罗罗	name, girl
初代シモアマヅ	初代下天津	name, girl
セレスタ	钢片琴	name, girl
イズリントン	伊斯灵顿	name, girl
イチジク	无花果	name, girl
クインズウェイ	皇后路	name, girl
プトラ	布特拉	name, girl
ヴィヴィアン	薇薇安	name, girl
ニコレッタ・パガニーニ	尼古洛·帕格尼尼	name, girl
チャイブ	细香葱	name, girl
リンガー	手铃	name, girl
